
WWWWWWWWWWWWWWWWWWWWWWWWWWWWWWWWW
W...............................W
W....M.........................BW
W.....X.........................W
W.....BBBBBBBB.................BW
W...............................W
W...............................W
W...........................A...W
W...............................W
W..............................BW
W...............................W
W...............................W
W.....B....B.......B.....B...B..W
WWWWWWWWWWWWWWWWWWWWWWWWWWWWWWWWW
