
WWWWWWWWWWWWWWWWWWWW
WW.......WWWW..W...W
WW.WWWWW....W..W.B.W
WW.W.....WWBW......W
WW.W.B....M..M.MM.MW
WW.W.A....W..W.M.M.W
WW.WWWWWW..W.W.M...W
W..........W.W.M.W.W
W..WWWWWWWWW.WM.WW.W
W................W.W
WWWWWWWWWWWWWW...WXW
WWWWWWWWWWWWWWWWWWWW
