WWWWWWWWWWWWW
W.....MX....W
WAMMMMM.....W
W.A...M.....W
W...........W
W.....W.....W
WWWWWWWWWWWWW
