
WWWWWWWWWWWWW
W...........W
W.B.MMMMMMM.W
W.M..MXMMMM.W
W...MMMMMMB.W
W.....M.MMM.W
WM.....A....W
WWWWWWWWWWWWW
